0000000111
0000001111
0000011111
0000011111
0000001111
0000000111
0011110111
1111110011
1111111000
1111111100