2222111112
1122211122
0012210222
0002202122
0000000011
0000000000
0011122000
0011222000
0000111000
0000000000